#############
#p          #
#           #
#    p      #
#   ppp     #
#  ppppp    #
#   ppp     #
#    p      #
#          p#
#############
