###################
#           #######
#  bb  bb   #######
#  pp  pp         #
#                 #
#                 #
# b  p  p b       #
#  bbbbbbb       ##
#           ##    #
###################
