################################################################
#``````````````````````````````````````````````````````````````#
#``````````````````````````````````````````````````````````````#
#``````````````````````````````````===========`````````````````#
#``````````````````````````````````````````````````````````````#
#``````````````````````````````````````````````````````````````#
#``````````````````````````````$```````````````````````````````#
#`````````````````````````````````````````````$````````````````#
#````````````============``````````````````````````````````````#
#`````$````````````````````````````````````````````````````````#
#``````````````````````````````````````````````````````````````#
#``````````````````````````````````````````````````````````````#
#`````````````````````````````````````````````==```````````````#
#``````````````````````````````````````````````````````````````#
#``````````````````````````````````````````````````````````````#
#```````````````````````$```````=======================````````#
#``````````````````````````````````````````````````````````````#
#``````````````````````````````````````````````````````````````#
#``````````````````````````````````````````````````````````````#
#``````````````````````````````````````````````````````````````#
#``````````=====================```````````````````````````````#
#``````````````````````````````````````````````````````````````#
#````````````````````````````````````````$`````````````````````#
#```````````````````````````````@``````````````````````````````#
#```````$``````````````````````````````````````````````````````#
#``````````````````````````````````````````````````````````````#
#```````````````````````````````````````````````===````````````#
#`````========`````````````````````````````````````````````````#
#``````````````````````````````````````````````````````````````#
#``````````````````````````````````````````````````````````````#
#``````````````````````$``````````==============```````````````#
#``````````````````````````````````````````````````````````````#
#`````````````````````````````````````````````````````````$````#
#``````````````````````````````````````````````````````````````#
#``````````````````````````````````````````````````````````````#
#``````````````````````````````````````````````````````````````#
#``````````````````````````````````````````````````````````````#
#`````````````=============``````````````$`````````````````````#
#```````````````````````````````````````````============```````#
#``````````````````````````````````````````````````````````````#
#``````````````````````````````````````````````````````````````#
#``````````````````````===========================`````````````#
#``````````````````````````````````````````````````````````````#
#`````````````````````````````````````````````````````$````````#
#```````$``````````````````````````````````````````````````````#
#``````````````````````````````````````````````````````````````#
#```````=======================``````````$`````````````````````#
#``````````````````````````````````````````````````````````````#
#``````````````````````````````````````````````````````````````#
################################################################